Aatrox|Aatrox unleashes his demonic form, fearing nearby enemy minions and gaining attack damage, increased healing, and Move Speed. If he gets a takedown, this effect is extended.
Ahri|Ahri dashes forward and fires essence bolts, damaging nearby enemies. Spirit Rush can be cast up to three times before going on cooldown, and gains additional recasts when taking down enemy champions.
Akali|Akali leaps in a direction, damaging enemies she strikes. Re-cast: Akali dashes in a direction, executing all enemies she strikes.
Akshan|Akshan locks onto an enemy champion and starts storing bullets. When released, he fires all stored bullets, dealing damage based on missing health to the first champion, minion, or structure hit.
Alistar|Alistar lets out a wild roar, removing all crowd control effects on himself, and reducing incoming physical and magical damage for the duration.
Amumu|Amumu entangles surrounding enemy units in bandages, applying his Curse, damaging and stunning them.
Anivia|Anivia summons a driving rain of ice and hail to damage her enemies and slow their advance.
Annie|Annie wills her bear Tibbers to life, dealing damage to units in the area. Tibbers can attack and also burns enemies that stand near him.
Aphelios|Fire a concentrated blast of moonlight that explodes on enemy champions. Applies the unique effect of Aphelios' main-hand gun.
Ashe|Ashe fires a missile of ice in a straight line. If the arrow collides with an enemy Champion, it deals damage and stuns the Champion, stunning for longer the farther arrow has traveled. In addition, surrounding enemy units take damage and are slowed.
Aurelion Sol|Aurelion Sol projects a blast of pure starfire, damaging and slowing all enemies caught in it and knocking nearby enemies back to a safer distance.
Azir|Azir summons a wall of soldiers which charge forward, knocking back and damaging enemies.
Bard|Bard sends spirit energy arcing to a location, putting all champions, minions, monsters, and turrets hit into stasis for a brief time.
Bel'Veth|Bel'Veth consumes Void coral remnants, transforming into her true form and increasing her max health, attack range, attack speed, and out-of-combat move speed. Consuming the Void coral remnants of a Void epic monster will grant her a longer ultimate duration, as well as the power to summon Void remora.
Blitzcrank|Enemies attacked by Blitzcrank are marked and take lightning damage after 1 second. Additionally, Blitzcrank can activate this ability to remove nearby enemies' shields, damage them, and silence them briefly.
Brand|Brand unleashes a devastating torrent of fire that bounces up to 5 times off of Brand and nearby enemies, dealing magic damage to enemies each time bounce. Bounces prioritize stacking Blaze to max on Champions. If a target is ablaze, Pyroclasm will briefly slow them.
Braum|Braum slams the ground, knocking up enemies nearby and in a line in front of him. A fissure is left along the line that slows enemies.
Caitlyn|Caitlyn takes time to line up the perfect shot, dealing massive damage to a single target at a huge range. Enemy champions can intercept the bullet for their ally.
Camille|Camille dashes to target champion, anchoring them to the area. She also deals bonus magic damage to the target with her basic attacks.
Cassiopeia|Cassiopeia releases a swirl of magical energy from her eyes, stunning any enemies in front of her that are facing her and slowing any others with their back turned.
Cho'Gath|Devours an enemy unit, dealing a high amount of true damage. If the target is killed, Cho'Gath grows, gaining maximum Health.
Corki|Corki fires a missile toward his target location that explodes on impact, dealing damage to enemies in an area. Corki stores missiles over time, up to a maximum. Every 3rd missile fired will be a Big One, dealing extra damage.
Darius|
Diana|Diana reveals and draws in all nearby enemies and slows them. If Diana pulls in one or more enemy champions, the moonlight crashes down onto her after a short delay, dealing magic damage in an area around her, increased for each target beyond the first pulled.
Dr. Mundo|Dr. Mundo pumps himself with chemicals, instantly healing a percent of his missing Health. He then gains bonus Attack Damage and Move Speed, and regenerates a portion of his maximum Health over a long duration.
Draven|Draven hurls two massive axes to deal physical damage to each unit struck. Whirling Death slowly reverses direction and returns to Draven after striking an enemy champion. Draven may also activate this ability while the axes are in flight to cause it to return early. Deals less damage for each unit hit and resets when the axes reverse direction. Executes enemies who have less health than Draven's number of Adoration stacks.
Ekko|Ekko shatters his timeline, becoming untargetable and rewinding to a more favorable point in time. He returns to whenever he was a few seconds ago, and heals for a percentage of the damage received in that duration. Enemies near his arrival zone take massive damage.
Elise|Transforms into a menacing spider, reducing her attack range in exchange for Move Speed, new abilities, and a Spiderling swarm that will attack her foes.
Evelyn|Evelynn briefly goes untargetable and decimates the area in front of her before warping backwards a long distance.
Ezreal|Ezreal winds up before firing a powerful barrage of energy that deals massive damage to each unit it passes through (damage is reduced for minions and non-epic monsters).
Fiddlesticks|A murder of crows flock wildly around Fiddlesticks, dealing damage per second to all enemy units in the area.
Fiora|Fiora reveals all four Vitals on an enemy champion and gains Move Speed while near them. If Fiora hits all four Vitals or if the target dies after she has hit at least one, Fiora and her allies in the area are healed over the next few seconds.
Fizz|Fizz tosses a fish in a direction that attaches to any champion that touches it, slowing the target. After a short delay, a shark erupts from the ground, knocking up the target and knocking any nearby enemies aside. All enemies hit are dealt magic damage and slowed.
Galio|Galio designates an ally's position as his landing spot, granting all allies in the area a magic shield. After a delay Galio smashes down location, knocking up nearby enemies.
Gangplank|Gangplank signals his ship to bombard an area, slowing and damaging enemies.
Garen|Garen calls upon the might of Demacia to attempt to execute an enemy champion.
Gnar|Mega Gnar throws everything around him in a chosen direction, dealing damage and slowing them. Any enemy that hits a wall is stunned and takes bonus damage.
Gragas|Gragas hurls his cask to a location, dealing damage and knocking back enemies caught in the blast radius.
Graves|Graves fires an explosive shell dealing heavy damage to the first champion it hits. After hitting a champion or reaching the end of its range, the shell explodes dealing damage in a cone.
Gwen|Gwen hurls a needle that slows enemies hit, deals magic damage, and applies A Thousand Cuts to champions hit. This ability can be cast up to two more times, with each cast throwing additional needles and dealing more damage. Gwen must hit an enemy between each cast to unlock the next one.
Hecarim|Hecarim summons spectral riders and charges forward, dealing magic damage in a line. Hecarim creates a shockwave when he finishes his charge, causing nearby enemies to flee in terror.
Heimerdinger|Heimerdinger invents an upgrade, causing his next spell to have increased effects.
Illaoi|Illaoi smashes her idol into the ground, dealing physical damage to nearby enemies. A Tentacle spawns for each enemy champion hit.
Irelia|Irelia fires a massive number of blades that explode outward upon hitting an enemy champion. Enemies hit by the blades are damaged and Marked. Afterwards the blades form a wall that will damage and slow enemies that walk through it.
Ivern|Ivern summons his Sentinel friend Daisy to fight with him. Daisy will send out a shockwave if she attacks the same champion three times in a row.
Janna|Janna surrounds herself in a magical storm, throwing enemies back. After the storm has settled, soothing winds heal nearby allies while the ability is active.
Jarvan|Jarvan IV heroically leaps into battle at a target with such force that he terraforms the surrounding area to create an arena around them. Nearby enemies are damaged at the moment of impact.
Jax|Every third consecutive attack deals additional Magic Damage. Additionally, Jax can activate this ability to strengthen his resolve, increasing his Armor and Magic Resist for a short duration.
Jayce|Hammer Stance: Transforms the Mercury Hammer into the Mercury Cannon gaining new abilities and increased range. The first attack in this form reduces the target's Armor and Magic Resist. Cannon Stance: Transforms the Mercury Cannon into the Mercury Hammer gaining new abilities and increasing Armor and Magic Resist. The first attack in this form deals additional magic damage.
Jhin|Jhin channels, transforming Whisper into a shoulder-mounted mega-cannon. It is able to fire 4 super shots at extreme range that pierce through minions and monsters, but stop on the first champion impacted. Whisper cripples enemies hit, which slows them and deals execute damage. The 4th shot is perfectly crafted, epically powerful, and guaranteed to critically strike.
Jinx|Jinx fires a super rocket across the map that gains damage as it travels. The rocket will explode upon colliding with an enemy champion, dealing damage to it and surrounding enemies based on their missing Health.
K'Sante|K'Sante smashes an enemy away. If the enemy hits a wall they will go through the wall taking more damage. K'Sante will appear behind the target and goes All Out by shredding his defenses but greatly increasing his damage.
Kai'Sa|Kai'Sa dashes near an enemy champion.
Kalista|Kalista teleports the Oathsworn ally to herself. They gain the ability to dash toward a position, knocking enemy champions back.
Karma|Karma empowers her next ability to do an additional effect. Mantra is available at level 1 and does not require a skill point.
Karthus|After channeling for 3 seconds, Karthus deals damage to all enemy champions.
Kassadin|Kassadin teleports to a nearby location dealing damage to nearby enemy units. Multiple Riftwalks in a short period of time cost additional Mana but also deal additional damage.
Katarina|Katarina becomes a flurry of blades, dealing massive magic damage while she channels to the 3 nearest enemy champions.
Kayle|Kayle makes an ally invulnerable and calls upon former Aspects of Justice to purify the area around her target with a holy rain of swords.
Kayn|Kayn hides in an enemy's body, dealing massive damage when he bursts out.
Kennen|Kennen summons a storm that strikes at nearby enemy champions for magical damage.
Kha'Zix|Each rank allows Kha'Zix to evolve one of his abilities, giving it a unique additional effect. When activated, Kha'Zix becomes Invisible, triggering Unseen Threat and increasing Move Speed. If he chooses to Evolve Adaptive Cloaking, Void Assault gains increased Invisibility duration, and an additional use.
Kindred|Lamb grants all living things inside a zone a respite from death. Until the effect ends, nothing can die. At the end, units are healed.
Kled|Kled and Skaarl charge to a location, leaving a speed-granting trail behind them and gaining a shield. Skaarl locks onto and rams the first enemy champion encountered.
Kog'Maw|Kog'Maw fires an artillery shell at a great distance dealing magic damage (increased significantly on low health enemies) and revealing non-stealthed targets. Additionally, multiple Living Artilleries in a short period of time cause them to cost additional Mana.
Leblanc|LeBlanc casts a mimicked version of one of her basic spells.
Lee Sin|Lee Sin performs a powerful roundhouse kick launching his target back, dealing physical damage to the target and any enemies they collide with. Enemies the target collides with are knocked into the air for a short duration. This technique was taught to him by Jesse Perring, although Lee Sin does not kick players off the map.
Leona|Leona calls down a beam of solar energy, dealing damage to enemies in an area. Enemies in the center of the area are stunned, while enemies on the outside are slowed.
Lillia|Lillia causes all enemies with Dream Dust on them to become Drowsy before falling asleep. Those enemies will take extra damage on being forcibly woken up.
Lissandra|If cast on an enemy champion, the target is frozen solid, stunning it. If cast on Lissandra, she encases herself in dark ice, healing herself while becoming untargetable and invulnerable. Dark ice then emanates from the target dealing magic damage to enemies and slowing Move Speed.
Lucian|Lucian unleashes a torrent of shots from his weapons.
Lulu|Lulu enlarges an ally, knocking nearby enemies into the air and granting the ally a large amount of bonus health. For the next few seconds, that ally gains an aura that slows nearby enemies.
Lux|After gathering energy, Lux fires a beam of light that deals damage to all targets in the area. In addition, triggers Lux's passive ability and refreshes the Illumination debuff duration.
Malphite|Malphite launches himself to a location at high speed, damaging enemies and knocking them into the air.
Malzahar|Malzahar channels the essence of the Void to suppress an enemy champion over a zone of damaging negative energy.
Maokai|Maokai summons a colossal wall of brambles and thorns that slowly advances forwards, damaging and rooting any enemies in the path.
Master Yi|Master Yi moves with unparalleled agility, temporarily increasing his Move Speed and Attack Speed as well as making him immune to all slowing effects. While active, Champion kills or assists extend Highlander's duration. Passively reduces cooldown for his other abilities on a kill or assist.
Miss Fortune|Miss Fortune channels a barrage of bullets into a cone in front of her, dealing large amounts of damage to enemies. Each wave of Bullet Time can critically strike.
Mordekaiser|Mordekaiser drags his victim to a different dimension with him and steals a portion of their stats. If he kills them, he keeps the stats until the victim respawns.
Morgana|
Nami|Summons a massive Tidal Wave that knocks up, slows, and damages enemies. Allies hit gain double the effect of Surging Tides.
Nasus|Nasus unleashes a mighty sandstorm that batters nearby enemies. While the storm rages, he gains increased Health, Attack Range, damages nearby enemies, has a reduced cooldown on Siphoning Strike, and gains bonus Armor and Magic Resistance.
Nautilus|Nautilus fires a shockwave into the earth that chases an opponent. This shockwave rips up the earth above it, knocking enemies into the air. When it reaches the opponent, the shockwave erupts, knocking his target into the air and stunning them.
Neeko|After a short preparation, Neeko leaps into the air and gains a shield. Upon landing, nearby enemies are damaged and stunned. The preparation is hidden if Neeko is disguised.
Nidalee|Nidalee transforms into a cougar, gaining new abilities.
Nilah|Twirling her whip-blade in joyful exuberance, Nilah deals damage to enemies around her before pulling them closer with her weapon.
Nocturne|Nocturne reduces the sight radius of all enemy champions and removes their ally vision in the process. He can then launch himself at a nearby enemy champion.
Nunu & Willump|Nunu & Willump create a powerful blizzard in an area that slows enemies and deals massive damage at the end.
Olaf|Olaf passively gains increased armor and magic resist. He can activate this ability to become immune to disables for as long as he keeps attacking.
Orianna|Orianna commands her Ball to unleash a shockwave, dealing magic damage and launching nearby enemies towards the Ball after a short delay.
Ornn|Ornn summons a massive elemental at a location which travels toward him with increasing speed. Enemies run over by the elemental take damage, are slowed and are made Brittle. Ornn can recast the ability to charge into the elemental, redirecting it in the direction he hits it, causing the elemental to affect any enemies it runs over to be knocked up, dealing the same damage and re-applying Brittle.
Pantheon|Pantheon composes himself and then leaps into the air, landing at a chosen location as a comet.
Poppy|Poppy channels a hammer strike that knocks enemies very far away.
Pyke|Pyke blinks to and executes low health enemies, allowing him to cast this spell again and granting additional gold to an ally who assists.
Qiyana|Qiyana sends out a shockwave that detonates whatever elements she hits with it, stunning and damaging nearby enemies.
Quinn|Quinn and Valor team up to fly around at great speed. Ending the ability casts Skystrike, which deals damage to nearby enemies and marks champions as Vulnerable.
Rakan|Gains Move Speed, charming and dealing magic damage to enemies touched.
Rammus|Rammus hops into the air and slams down at a target area, dealing magic damage and slowing enemies. If cast while Rammus is in Powerball, Rammus knocks up enemies near the center as well.
Rek'Sai|Rek'sai passively marks targets by damaging them. She can activate this ability to become briefly untargetable and lunge at a marked target for heavy damage based on their missing health.
Rell|Rell explodes in a magnetic fury, violently Pulling nearby enemies towards herself. Then Rell constantly Drags nearby enemies towards herself for a short while, dealing magic damage over time.
Renata Glasc|Renata sends out a wave of chemicals, causing any enemies hit to go Berserk.
Renekton|Renekton transforms into the Tyrant form, gaining bonus Health and dealing damage to enemies around him. While in this form, Renekton gains Fury periodically.
Rengar|Rengar's predatory instincts take over, Camouflaging him and revealing the nearest enemy champion in a large radius around him. During Thrill of the Hunt, Rengar gains Move Speed and he can leap to the tracked enemy without being in brush, reducing their armor.
Riven|Riven empowers her keepsake weapon with energy, and gains Attack Damage and Range. During this time, she also gains the ability to use Wind Slash, a powerful ranged attack, once.
Rumble|Rumble fires off a group of rockets, creating a wall of flames that damages and slows enemies.
Ryze|Passively, Overload deals even more damage against targets with Flux. On cast, Ryze creates a portal to a nearby location. After a few seconds, allies standing near the portal are teleported to the target location.
Samira|Samira unleashes a torrent of shots from her weapons, wildly shooting all enemies surrounding her.
Sejuani|Sejuani throws her bola that freezes and stuns the first champion hit and creates an ice storm that slows other enemies.
Senna|Senna calls upon the relic stones of fallen Sentinels, splitting her relic cannon into a holy array of shadow and light. She then fires a global beam that shields allies from harm, while damaging enemies caught in the center.
Seraphine|Seraphine deals damage and charms enemies hit, refreshing the range with every allied or enemy champion hit.
Sett|Sett carries an enemy champion through the air and slams them into the ground, dealing damage and slowing all enemies near where they land.
Shaco|Shaco creates an illusion of himself near him, which can attack nearby enemies (Deals reduced damage to turrets). Upon death, it explodes, spawning three mini Jack in the Boxes and dealing damage to nearby enemies.
Shen|Shen shields target allied champion from incoming damage, and soon after teleports to their location.
Shyvana|Shyvana transforms into a dragon and takes flight to a target location. Enemies along her path take damage and are knocked toward her target location. Shyvana passively gains Fury per second and gains 2 Fury on basic attack.
Singed|Singed drinks a potent brew of chemicals, granting him increased combat stats, and making his Poison Trail apply Grievous Wounds.
Sion|Sion charges in a direction, ramping up speed over time. He can steer his charge slightly with the mouse cursor location. When he collides with an enemy he deals damage and knocks them up based on the distance he has charged.
Sivir|Sivir leads her allies in battle, granting them a surge of Move Speed for a period of time. In addition, Sivir's attacks reduce her spell cooldowns.
Skarner|Skarner suppresses an enemy champion and deals damage to it. During this time, Skarner can move freely and will drag his helpless victim around with him. When the effect ends, the target will be dealt additional damage.
Sona|Sona plays her ultimate chord, stunning enemy champions and forcing them to dance and dealing magic damage to them. Each rank reduces the base cooldown of Sona's basic abilities.
Soraka|Soraka fills her allies with hope, instantly restoring health to herself and all allied champions.
Swain|Swain transforms into a demon and drains health from nearby enemy champions, minions, and neutral monsters. Swain can cast Demonflare to decimate and slow nearby enemies with a nova of soulfire. This form is indefinite as long as Swain drains enemy champions.
Sylas|Sylas steals the enemy's ultimate ability and can cast it freely.
Syndra|Syndra bombards an enemy Champion with all of her Dark Spheres.
Tahm Kench|Tahm Kench devours a champion for a few seconds, dealing magic damage if they are an enemy, or shielding them if they are an ally.
Taliyah|Taliyah creates a very long wall and then surfs it.
Talon|Talon disperses a ring of blades and becomes Invisible while gaining additional Move Speed. When Talon emerges from Invisibility, the blades converge on his location. Each time the blades move, Shadow Assault deals physical damage to enemies hit by at least one blade.
Taric|Pulses cosmic energy onto nearby allied champions after a delay, making them invulnerable for a short duration.
Teemo|Teemo throws an explosive poisonous trap using one of the mushrooms stored in his pack. If an enemy steps on the trap, it will release a poisonous cloud, slowing enemies and damaging them over time. If Teemo throws a mushroom onto another mushroom it will bounce, gaining additional range.
Thresh|A prison of walls that slow and deal damage if broken.
Tristana|Tristana loads a massive cannonball into her weapon and fires it at an enemy unit. This deals Magic Damage and knocks the target back. If the target is carrying the Explosive Charge bomb, the bomb detonation radius is doubled.
Trundle|Trundle immediately steals a percent of his target's Health, Armor and Magic Resistance. Over the next 4 seconds the amount of Health, Armor, and Magic Resistance stolen is doubled.
Tryndamere|Tryndamere's lust for battle becomes so strong that he is unable to die, no matter how wounded he becomes.
Twisted Fate|Twisted Fate predicts the fortunes of his foes, revealing all enemy champions and enabling the use of Gate, which teleports Twisted Fate to any target location in 1.5 seconds.
Twitch|Twitch unleashes the full power of his crossbow, shooting bolts over a great distance that pierce all enemies caught in their path.
Udyr|Udyr surrounds himself in a glacial storm, damaging and slowing nearby enemies. Recast: Empower and unleash the storm, causing it to track enemies and deal additional damage.
Urgot|Urgot fires a chem-drill that impales the first enemy champion hit. If that champion falls below a health threshold, Urgot judges them weak and can execute them.
Varus|Varus flings out a damaging tendril of corruption that immobilizes the first enemy champion hit and then spreads towards nearby uninfected champions, immobilizing them too on contact.
Vayne|Readying herself for an epic confrontation, Vayne gains increased Attack Damage, Invisibility during Tumble, reduced Tumble cooldown, and more bonus Move Speed from Night Hunter.
Veigar|Blasts target enemy champion, dealing a large amount of magic damage, increasing based on the target's missing health.
Vel'Koz|Vel'Koz unleashes a channelled beam that follows the cursor for 2.5 seconds that deals magic damage. Organic Deconstruction Researches enemy champions causing them to take true damage instead.
Vex|Fire a missile that marks an enemy champion. Recast to dash to them and deal damage.
Viego|Viego teleports to a nearby location and executes an enemy champion on arrival, piercing their heart and causing a destructive shockwave around them that knocks away their allies.
Viktor|Viktor conjures a singularity on the field which deals magic damage and interrupts enemy channels. The singularity then periodically does magic damage to all nearby enemies. Viktor can redirect the singularity. Augment: The Chaos Storm moves 25% faster.
Vi|Vi runs down an enemy, knocking aside anyone in the way. When she reaches her target she knocks it into the air, jumps after it, and slams it back into the ground.
Vladimir|Vladimir infects an area with a virulent plague. Affected enemies take increased damage for the duration. After a few seconds, Hemoplague deals magic damage to infected enemies and heals Vladimir for each enemy Champion hit.
Volibear|Volibear leaps to a target location, Slowing and damaging enemies beneath him while gaining bonus Health. Enemy towers near his landing location become temporarily disabled.
Warwick|Warwick leaps in a direction (scaling with his bonus Move Speed), suppressing the first champion he collides with for 1.5 seconds.
Wukong|Wukong's extends his staff and spins it around repeatedly, gaining Move Speed. Enemies struck take damage and are knocked up.
Xayah|Xayah leaps into the air becoming untargetable and throwing out a fan of daggers, dropping Feathers she can recall.
Xerath|Xerath immobilizes himself and gains numerous long-range barrages.
Xin Zhao|Xin Zhao challenges an enemy he damaged recently. Xin Zhao deals damage to nearby enemies based on their current Health and knocks non-challenged targets back, becoming impervious to damage dealt by champions outside of the circle created.
Yasuo|Blinks to an Airborne enemy champion, dealing physical damage and holding all Airborne enemies in the area in the air. Grants maximum Flow but resets all stacks of Gathering Storm. For a moderate time afterwards, Yasuo's critical strikes gain significant Bonus Armor Penetration.
Yone|Yone blinks behind the last champion in a line with a slash so powerful it pulls all enemies hit towards him.
Yorick|Yorick summons the Maiden of the Mist that causes Yorick's attacks against the Maiden's target to deal bonus damage. The Maiden will also automatically raise Walkers from dead enemies.
Yuumi|Yuumi channels seven waves of damage, rooting anyone hit by three or more. Yuumi can move, attach, and cast Zoomies! while channeling.
Zac|Zac bounces four times, knocking up enemies hit and slowing them.
Zed|Zed becomes untargetable and dashes to an enemy champion, marking them. After 3 seconds the mark triggers, repeating a portion of all the damage Zed dealt to the target while they were marked.
Zeri|Zeri discharges a nova of electricity and overcharges herself, gaining increased damage and stacking Move Speed that refreshes and gets stronger every time she hits an enemy champion. While overcharged, Burst fire becomes a faster triple shot that chains lightning between enemies.
Ziggs|Ziggs deploys his ultimate creation, the Mega Inferno Bomb, hurling it an enormous distance. Enemies in the primary blast zone take more damage than those farther away.
Zilean|Zilean places a protective time rune on an allied champion, teleporting the champion back in time if they take lethal damage.
Zoe|Blink to a nearby position for 1 second. Then blink back.
Zyra|Zyra summons a twisted thicket at her target location, dealing damage to enemies as it expands and knocking them airborne as it contracts. Plants within the thicket are enraged.
